1111111111111111111111111111111111
1E00000000000000000000000000000001
1P000000000000000000000000000000C1
1000000000000000000000000000000001
1111011111111111111111111111111111
1000000000000000000000000000000001
10000000000000000000000000000000C1
1000000000000000000000000000000001
1111011111111111111111111111111111
1000000000000000000000000000000001
10000000000000000000000000000000C1
1000000000000000000000000000000001
1111011111111111111111111111111111
1000000000000000000000000000000001
10000000000000000000000000000000C1
1000000000000000000000000000000001
1111111111111111111111111111111111